department_name,East,North,South,West,All
Cardiology,133,122,138,126,519
Dermatology,102,112,125,124,463
Emergency,115,141,137,106,499
Endocrinology,130,135,121,122,508
Neurology,131,126,126,123,506
Oncology,159,145,141,124,569
Orthopedics,126,121,130,126,503
Pediatrics,95,92,98,80,365
Psychiatry,127,118,132,134,511
Radiology,149,142,140,126,557
All,1267,1254,1288,1191,5000
